15 00
01 01 01 01 01 01 01 
01 03 03 03 03 00 01 
01 03 01 03 03 03 01 
01 03 03 03 00 01 01 
01 03 01 03 00 00 01 
01 03 00 03 00 98 01 
01 01 01 01 01 01 01