03 00
00 00 01 01 00 00 00 
00 00 01 03 01 00 00 
00 00 03 00 03 00 01 
00 98 00 01 00 03 01 
00 00 00 00 01 00 01 
01 03 01 00 00 01 01 
01 01 01 00 00 01 01